NO ./textures/wall_n.xpm
SO ./textures/wall_s.xpm
WE ./textures/wall_w.xpm
EA ./textures/wall_e.xpm

F 220,100,0
C 225,30,0

111111
100100
100001
110001
111111
