NO textures/wall_n.xpm
SO textures/wall_s.xpm
WE textures/wall_w.xpm
EA textures/wall_e.xpm

F 999,999,999
C 225,30,0

111111
100001
100N01
111111